******* ****************************************** 
*                                                *
* ****************** ********* *******************
*        *         * *       * *                 *
****** * * ******* * * ***** * * *****************
*      * * *&      * * * * * * * *               *
* ****** * ********* * * * * * *** ***************
*      *   *         *   *         ***************
**************************************************
